111111111111111
1001000001E1111
100001000000111
10PC01000000111
111111111111111