1111111111111
1001000E10001
1000010010C01
1P1C110010001
1111111111111